1111000000
0011100100
0111001100
1100001000
0111111000
0000000000
0000000000
0000000000
0000000000
0000000000