1111111000
0000011111
0000000110
0000001100
0000111000
0000000000
0000000000
0000000000
0000000000
0000000000