1110000000
0111000000
0011111000
0001111000
0011000000
0000000000
0000000000
0000000000
0000000000
0000000000
