1110000000
0111110000
0011102100
0001111000
0000130000
0000000000
0000000000
0000000000
0000000000
0000000000